022222
0210222
0203002
22202022
24252002
24300202
24050302
22222222
